------------------
111111111111111111
------------------
111111111111111111
------------------
111111111111111111
--------B----R----
11111111111-111111
------------------
111111111111111111
---C----&----B----
111111111111111111