------------------
111111111111111111
-----B------------
111111111111111111
------------------
111111111111111111
----R------B------
111111111111111111
-----&------------
111111111111111111
------------------
111111111111111111