------------------
111111111111111111
------------------
111111111111111111
------------------
111111111111111111
----B---B---------
111111111111111111
--------R---------
111111111111111111
--------&---------
111111111111111111