------------------
111111111111111111
------------------
111111111111111111
------------------
111111111111111111
--------B---------
11111111111-111111
--------R---------
111111111111111111
---C----&----B----
111111111111111111